players 2
rows 90
cols 114
............................................%.....................%%%%%%.......................................%..
........%...................................%....................%%.......................%%......................
......%%%...................................%........%%........%%%.............................%..................
.....%%......%%%...........%%......%........%%........%.....%%%%%%..............%.................................
.....%......%.............%%.......%.........%.........%%%%%%....%...........%%%..................................
.....%....................%.........%........%%........%%%.......%..........%............................%%%%%....
....%%...................%%..........%........%..................%....................%......................%....
....%................%%%%%...........%%.......%...................%...................%%.....................%....
....%...........................1....%%.......%%..................%...................%%%.....................%...
....%...............................%..........%..................%.....................%%........%...........%...
.....%.............................%...........%........%........%%.......%..............%%.....%%%...........%...
......%....................%......%............%%......%........%%........%................%%%%%%..%..........%...
.......%%%%%%..............%.....%.............%%%%%%.%........%%..........%................%......%..........%...
.............%%...........%%.....%...........%%.....%%.....................%.......%........%.......%........%%%..
..............%%%%........%......%.........%%..............................%%......%........%...............%%%%%.
..........................%.......%.......%%.............................%%%...............%...............%....%%
%........................%%.......%.......%.............................%%.................%...............%.....%
%%.......................%........%%............................%.....%%%.................%%...............%......
.%%%....................%%.........%%%%..............................%%................%%%........%.......%%......
..%%%...................%%............................%..............%...............%%%.......%%%%.......%.......
.........................%.............................%.......................................%..........%.......
.........................%%....................%........%...%%............................................%.......
...........................%%%.................%.........%%%%............................................%%.......
...........%%%..............%%...............................................%%.........................%%........
..........%%.%%%......................................................%.........................................%%
................%%....................................................%..................%.......................%
.......................................%%.....%.........%............%.......................%%..................%
..................................%......%.............%%...........%%...........................................%
%....................................................%%..%.........%%...........%.....................%%.........%
.......%...........................................%%.....%.......%..............%%...............................
.....%%...........................................%%.......%......%................%%............%................
.........................%%.................................%......................%%............%................
...................%.......................................................%.......%%...........%.................
...................%...............................................................%............%..........%%.....
..................%%.............%......%%.........................................%...........%...........%......
...............%%%%.............%%.......%%.......................................%%.......%%%%%..........%%......
.............%%.................%.........%%.%.....................%..............%............%%........%%.......
...............................%%..........%%%%..................%%%......%.......%.............%........%........
...............................%..........%%..%%.......%%%%%...%%%.......%%......%%.....................%%........
..............................%%..........%....%%..........%%%%%.........%........%....................%%.........
..%..........................%%..........%%.....%%............%..........%.........%%%.................%..........
..%%%%%%.....................%...........%.......%%%.....................%...........%%%...............%..........
.%.....%%%............%.................%%........%%....................%..............%...............%%.........
%%........%............................%%.........%%.....................%%............%%..............%%.........
%.........%%............................%.........%%%............%.......%%%%%..........%.....%%.......%.........%
........................................%..........%%%%..........%............%%%.......%%...%%%%%%%%%%..........%
........................................%%............%%%.......%...............%%.......%%.%%......%%...........%
...................%%...................................%%%.....%................%.......%%%%....................%
.....................%....................................%.....%................%.......%%%.....................%
......................%.........%.........................%%....%....%%%%..............%%........................%
.......................%.......%%..............%%%%..............%%%%....%............%.........................%.
........................%.......%..........%%%%%..........................%..........................%%........%%.
...........................................%%.............................%%%%................%.....%%........%%..
........%..................................%..................................................%.....%.........%...
........%%................................%%..........%%............................................%%............
.........%%%%%%.......................................%..............................................%............
........%%.......................%%..............................%...................................%............
......%%%.............................%........................%%%...................................%........%%..
...%%%%%%..............%......................................%%......%%%...........%%......%........%%........%..
%%%%....%...........%%%.......................................%......%.............%%.......%.........%.........%%
%.......%..........%............................%%%%%.........%....................%.........%........%%........%%
........%....................%......................%........%%...................%%..........%........%..........
.........%...................%%.....................%........%................%%%%%...........%%.......%..........
.........%...................%%%.....................%.......%...........................0....%%.......%%.........
.........%.....................%%........%...........%.......%...............................%..........%.........
........%%.......%..............%%.....%%%...........%........%.............................%...........%........%
.......%%........%................%%%%%%..%..........%.........%....................%......%............%%......%.
......%%..........%................%......%..........%..........%%%%%%..............%.....%.............%%%%%%.%..
..................%.......%........%.......%........%%%...............%%...........%%.....%...........%%.....%%...
..................%%......%........%...............%%%%%...............%%%%........%......%.........%%............
................%%%...............%...............%....%%..........................%.......%.......%%.............
...............%%.................%...............%.....%%........................%%.......%.......%..............
.......%.....%%%.................%%...............%......%%.......................%........%%.....................
............%%................%%%........%.......%%.......%%%....................%%.........%%%%..................
............%...............%%%.......%%%%.......%.........%%%...................%%............................%..
......................................%..........%................................%.............................%.
...%%............................................%................................%%....................%........%
%%%%............................................%%..................................%%%.................%.........
....................%%.........................%%...................%%%..............%%...........................
.............%.........................................%%..........%%.%%%.........................................
.............%..................%.......................%................%%.......................................
............%.......................%%..................%.......................................%%.....%.........%
...........%%...........................................%..................................%......%.............%%
%.........%%...........%.....................%%.........%%....................................................%%..
.%.......%..............%%......................................%...........................................%%....
..%......%................%%............%.....................%%...........................................%%.....
...%......................%%............%.........................................%%..............................
..................%.......%%...........%....................................%.....................................
..........................%............%..........%%........................%.....................................
..........................%...........%...........%........................%%.............%......%%...............
