players 2
rows 43
cols 39
%%%%%...........%%%%%%%...........%%%%%
%%%%%.............................%%%%%
%%%%%.............................%%%%%
%%%%%.............................%%%%%
%%%%%.............................%%%%%
%%%%%.............................%%%%%
%%%%%.............................%%%%%
%%%%%.............................%%%%%
%%%%%.............................%%%%%
%%%%%.............................%%%%%
%%%%%.............................%%%%%
%%%%%.............................%%%%%
%%%%%.............................%%%%%
%%%%%.............................%%%%%
%%%%%..............1..............%%%%%
%%%%%.............................%%%%%
%%%%%.............................%%%%%
%%%%%.............................%%%%%
%%%%%.............................%%%%%
%%%%%............%...%............%%%%%
%%%%%.............%%%.............%%%%%
%%%%%.............................%%%%%
%%%%%.............%%%.............%%%%%
%%%%%............%...%............%%%%%
%%%%%.............................%%%%%
%%%%%.............................%%%%%
%%%%%.............................%%%%%
%%%%%.............................%%%%%
%%%%%..............0..............%%%%%
%%%%%.............................%%%%%
%%%%%.............................%%%%%
%%%%%.............................%%%%%
%%%%%.............................%%%%%
%%%%%.............................%%%%%
%%%%%.............................%%%%%
%%%%%.............................%%%%%
%%%%%.............................%%%%%
%%%%%.............................%%%%%
%%%%%.............................%%%%%
%%%%%.............................%%%%%
%%%%%.............................%%%%%
%%%%%.............................%%%%%
%%%%%...........%%%%%%%...........%%%%%
